4,4,4,4,4,4,4,4,4,4,4,4,4,4,4,4,4,4,4,4,4,4,4,4,4,4,4,4,4,4,4,4,4,4,4,4,4,4,4,4
4,4,4,1,1,1,1,1,1,1,1,4,4,1,1,3,1,1,1,1,4,4,1,1,1,1,1,4,4,1,1,1,1,1,1,1,1,4,4,4
4,4,4,1,0,1,1,1,1,1,1,4,4,1,1,1,1,1,1,1,4,4,1,1,1,1,1,4,4,1,1,1,1,1,1,1,1,4,4,4
4,4,4,4,4,4,4,4,4,1,1,4,4,1,1,4,4,4,1,1,4,4,1,1,1,4,4,1,1,1,1,1,1,1,1,1,1,4,4,4
4,4,4,4,4,4,4,4,4,1,1,4,4,1,1,4,4,4,1,1,4,4,1,1,1,4,4,1,1,1,1,1,1,1,1,1,1,4,4,4
4,1,3,1,1,1,1,1,1,1,1,4,4,1,1,4,4,4,1,1,1,1,1,1,4,4,4,4,4,4,4,4,4,4,4,1,1,1,1,4
4,3,1,1,1,1,1,1,1,1,1,4,4,1,1,4,4,4,1,1,1,1,1,1,4,4,4,4,4,4,4,4,4,4,4,1,1,1,1,4
4,1,1,4,4,4,4,4,4,1,1,1,1,1,1,1,1,1,1,1,1,1,1,1,4,4,1,1,1,1,1,1,1,4,4,1,1,1,1,4
4,1,1,4,4,4,4,4,4,1,1,1,1,1,1,1,1,1,1,1,1,1,1,1,4,4,1,1,1,1,1,1,1,4,4,4,1,1,1,4
4,1,1,4,4,1,1,1,1,1,1,4,4,4,4,4,4,4,4,4,4,4,4,4,4,4,1,1,4,4,4,4,4,4,4,4,1,1,1,4
4,1,1,4,4,1,1,1,1,1,1,4,4,4,4,4,4,4,4,4,4,4,4,4,4,4,1,1,4,4,4,4,4,4,4,4,1,1,1,4
4,1,1,4,4,1,1,4,4,4,4,4,4,1,1,4,4,1,1,1,1,1,1,1,4,4,1,1,4,4,1,1,1,1,1,1,1,1,1,4
4,1,1,4,4,1,1,4,4,4,4,4,4,3,3,4,4,1,1,1,1,1,1,1,4,4,1,1,4,4,1,1,1,1,1,1,1,1,1,4
4,1,1,1,1,1,1,1,1,1,1,1,1,1,1,4,4,1,1,1,4,4,1,1,4,4,1,1,4,4,1,1,1,1,1,1,1,1,1,4
4,1,1,1,1,1,1,1,1,1,1,1,1,1,3,4,4,1,1,1,4,4,1,1,4,4,1,1,4,4,1,1,1,4,4,4,4,1,1,4
4,1,1,4,4,1,1,4,4,4,4,4,4,4,4,4,4,1,1,1,4,4,1,1,4,4,1,1,4,4,1,1,1,4,4,4,4,1,1,4
4,1,1,4,4,1,1,4,4,4,4,4,4,4,4,4,4,1,1,1,4,4,1,1,4,4,1,1,4,4,1,1,1,4,4,1,1,1,1,4
4,1,1,1,1,1,1,1,1,1,1,1,1,1,1,1,1,1,1,1,4,4,1,1,1,1,1,1,1,1,1,1,1,4,4,1,1,1,1,4
4,1,1,1,1,1,1,1,1,1,1,1,1,1,1,1,1,1,1,1,4,4,1,1,1,1,1,1,1,1,1,1,1,4,4,2,2,2,2,4
4,1,1,1,1,1,1,4,4,4,4,4,4,4,4,4,4,4,4,4,4,4,1,1,4,4,4,1,1,1,1,1,1,4,4,2,2,2,2,4
4,1,1,1,1,1,1,4,4,4,4,4,4,4,4,4,4,4,4,4,4,4,1,1,4,4,4,1,1,1,1,1,1,4,4,4,1,1,1,4
4,4,4,4,4,4,4,4,4,4,4,4,4,4,4,4,4,4,4,4,4,4,4,4,4,4,4,4,4,4,4,4,4,4,4,4,4,4,4,4
